000000000000000000000000000000000000000000000000000000000000000000000000000000000000000000000
011111111111111111111111111111111111111111111111111111111111111111111111111111111111111111110
010000000000000000000000000000000000000000000000000000000000000000000000000000000000000000010
010000000000000000000000000000000000000000000000000000000000000000000000000000000000000000010
010000000000000000000000000000000000000000000000000000000000000000000000000000000000000000010
010000001111111111111111111111111111111111111111111111111111111111111111111111111111100000010
010000001000000000000000000000000000000000000000000000000000000000000000000000000000100000010
010000001000000000000000000000000000000000000000000000000000000000000000000000000000100000010
010000001000000000000000000000000000000000000000000000000000000000000000000000000000100000010
010000001000000000000000000000000000000000000000000000000000000000000000000000000000100000010
010000001000000000000000000000000000000000000000000000000000000000000000000000000000100000010
010000001000000000000000000000000000000000000000000000000000000000000000000000000000100000010
010000001000000000000000000000000000000000000000000000000000000000000000000000000000100000010
010000001000000000000000000000000000000000000000000000000000000000000000000000000000100000010
010000001000000000000000000000000000000000000000000000000000000000000000000000000000100000010
010000001111111111111111111111111111111111111111111111111111111111111111111111111111100000010
010000000000000000000000000000000000000000000000000000000000000000000000000000000000000000010
010000000000000000000000000000000000000000000000000000000000000000000000000000000000000000010
010000000000000000000000000000000000000000000000000000000000000000000000000000000000000000010
011111111111111111111111111111111111111111111111111111111111111111111111111111111111111111110
000000000000000000000000000000000000000000000000000000000000000000000000000000000000000000000